-10
9
-6
5
00000000000000000000
01111111111001111110
01111111111001111110
01111111111000000110
01111111111000000110
01110111011000000000
01100000000000000000
01100000000000000110
01100000000000000110
01111111111111111110
01111111111111111110
00000000000000000000
