-6
6
-5
4
0000000000000
0111111111110
0111111111110
0111000111110
0111000000010
0111000110010
0000000110010
0000000110010
0100000000010
0000000000000
