-9
8
-5
4
111111111100111111
111111111100111111
111111000000000011
111111000000000011
111111000000000000
110000000000000000
110000000000000011
110000000000000011
111111111111111111
111111111111111111
