-10
9
-6
5
00000000000000000000
00000000000000000000
00000000000000000000
00000000000001111000
00000000000001111000
00000000000000000000
00000000000000000000
00000000000002222000
00000000000002222000
00000000000000000000
00000000000000000000
00000000000000000000
