-9
8
-5
4
000000000000000000
000000000000000000
000000222200111100
000000222200111100
000000000000000000
000000000000000000
000000000000111100
000000000000111100
000000000000000000
000000000000000000
