-8
7
-6
4
0000000000000000
0011111111111100
0111111111111110
0100011111100010
0000011111100000
0000000000000000
0110000000000000
0110000000001100
0110000000001100
0100000000000010
0000000000000000
